 72613261
0M.......
7........
3.M.T....
3........
3........
5........
2........
5........